O.  .OOOOOOOOOOOO.  OUOOOO.OOO
O.OO      OOOOOOO O.  OOOOO.OU
O .O OOOO OOO ..  OOOOOO OO OO
. O.   OO .OO.OOOO.OOOO  OOOOO
..O OO OOO    OOOOOOO OO.OOOOO
O.O OO.OOO OO OOOOOOOOO    OOO
O.O OO OOO OO.OOOOOOOOO O  OOO
O O.OO OOO OOOOOOOOOO   OO OOO
O.  OO OOO OO OOO OOO OOOO OOO
OO.OOO.OOO.OO.OOO OOO OOO   OO
OO OOO.OOO OO OOO.OOO OOOOO OO
OO  OO OOOOOO OOO.    OOOOO OO
O . OO     OO OOOOO OOOOO   OO
O O OO.OOO OO OOOOO OOOO  OOOO
O O OO.OOOX    OOOO.OOOO OOOOO
O.O  O OOOOOOO OOOO OOOO O  ..
O. O.O OOOOOOO.OOOO OOO  O. OU
UO O  .OOO     OO   OOO OO OOO
OO OOOOOOO OOOOOO OOOOO    OOO
OO O. .OOO.       OOOOOOOOOOOO
OO...OUOOOOOOOOOOOOOOOOO.OOUOO